aachen	ɑːkeːn
abbe	abɛ
abbot	abbɔt
aboensisk	abʊɛnsɪsk
abstinens	abstɪnɛns
abstinensbesvär	abstɪnɛnsbesvæːr
accent	akksɛnt
ackja	akja
ackusativ	akɵsatiːv
adde	adɛ
adel	ɑːdɛl
adjektiv	adjɛktiːv
adjö	ajøː
adla	ɑːdla
adlig	ɑdlɪɡ
advent	advɛnt
advokat	advʊkɑːt
affrikata	afrɪkɑːta
affär	afɛːr
afse	afsɛ
afton	aftɔn
aftonfalk	aftɔnfalk
aggressiv	aɡrɛsiːv
agna	aŋna
agneta	aŋneːta
agnosticism	aɡnɔstɪsɪsm
agnostiker	aɡːnɔstɪkɛr
aioli	ajoːlɪ
akaciames	akɑːsijameːs
aktie	aktsɪɛ
aktiebolag	aktsiɛbʊlɑːɡ
aktuell	aktɵɛl
akut	akʉːt
al	ɑːl
albatross	albatrɔs
albert	albæʈ
albertina	albæʈiːna
albin	albɪn
aldrig	aldriɡ
alert	alæʈ
alfabet	alfabeːt
alfågel	ɑːlfoːɡɛl
alförrädare	ɑːlfœrɛːdarɛ
alg	alj
algerier	alɧeːrɪɛr
algeriet	alɧɛriːɛt
algerisk	alɧeːrɪsk
alkekung	alkɛkɵŋ
alkohol	alkʊhoːl
alkoholism	alkʊhʊlɪsm
alkoholist	alkʊhʊlɪst
alla	ala
allemansrätt	allɛmansrɛtt
allihop	alɪhuːp
allihopa	alɪhuːpa
allmän	almɛn
allmänbildning	almɛnbɪldnɪŋ
alltmer	altmeːr
alltså	altsɔ
allvarlig	alvɑːrlɪɡ
alpseglare	alpseːɡlarɛ
altruism	altrɵɪsm
aluminium	alɵmiːnɪɵm
amanda	amanda
ambitiös	ambiɧøːs
amerika	ameːrɪka
amma	ama
amper	ampɛr
ampere	ampæːr
amurfalk	ɑːmɵrfalk
ana	ɑːna
and	and
anden	andɛn
andlig	andlɪɡ
andra	andra
andré	andreː
anfalla	anfalla
ange	anjeː
anka	aŋka
ankeborg	aŋkɛbɔrj
anklagelse	anklɑːɡɛlsɛ
anna	ana
annons	anɔns
anod	anoːd
anomali	anʊmaliː
ansat	ansat
ansikte	ansɪktə
anspråk	ansproːk
ansvarig	ansvɑːrɪɡ
antepenultima	antɛpɛnɵltɪma
antimon	antɪmuːn
antisemit	antɪsɛmiːt
antisemitisk	antɪsɛmiːtɪsk
antisemitism	antɪsɛmɪtɪsm
antyda	antyːda
apa	ɑːpa
apelsinjuice	apɛlsiːnjuːs
apotek	apʊteːk
appellativ	apɛlativ
april	apriːl
arbetslös	arbeːtsløːs
arbus	ɑrbʉːs
arg	arj
argon	arɡoːn
argt	arjt
arkimedes	arkɪmeːdɛs
arkitekt	arɕɪtɛkt
arkiv	arkiːv
arr	ar
arrangemang	aranɧemaŋ
arrangera	aranɧeːra
arsel	arsɛl
arsenik	arsɛniːk
arton	ɑːrtɔn
arv	arv
as	ɑːs
aspig	aspɪɡ
asturisk	astʉrɪsk
asturiska	astʉrɪska
att	at
attack	atakk
attityd	atɪtyːd
aubergine	ɔbɛrɕiːn
av	ɑːv
avbrott	ɑːvbrɔt
avfärda	ɑːvfɛrda
avgjord	ɑːvjuːrd
avgå	ɑːvɡoː
avgång	ɑːvɡɔŋ
avgöra	ɑːvjøːra
avi	aviː
avlat	ɑːvlɑːt
avlatskrämare	ɑːvlɑːtskrɛːmarɛ
avled	ɑːvleːd
avokado	avʊkɑːdʊ
avseende	ɑːvseːɛndɛ
avsiktlig	ɑːvsiktliː
avsked	ɑːvɧeːd
avsky	ɑːvɧyː
avskyvärd	ɑːvɧʏvɛːrd
avsluta	ɑːvslʉːta
aw	ɑːveː
axel	aksɛl
ba	bɑː
babbe	babɛ
babylift	bɛɪbʏlɪft
backsvala	baksvɑːla
bad	bɑːd
bada	bɑːda
badensisk	badɛnsɪsk
badstuga	bɑːdstʉːɡa
bajen	bajɛn
bajs	bajs
bajsa	bajsa
bak	bɑːk
bakbord	baːkbuːrd
balkansångare	balkansɔŋarɛ
ball	bal
balle	balɛ
bamba	bamba
bambamat	bambamɑːt
bambarast	bambarast
bambatant	bambatant
bana	bɑːna
banan	banɑːn
bananskal	banɑːnskɑːl
band	band
bane	bɑːnɛ
baneman	bɑːnɛman
bank	bɑŋk
bar	bɑːr
bara	bɑːra
barmhärtig	barmhɛʈɪɡ
barn	barn
barnbespisning	bɑːrnbɛspiːsnɪŋ
barnet	bɑːrnɛt
barnhem	bɑːrnhɛm
barnmorska	bɑːrnmʊrska
barriär	barɪæːr
barsk	baʂk
bas	bɑːs
basar	basɑːr
basket	basket
basta	basta
bea	beːa
bearbeta	beːarbeːta
bebop	biːbɔp
beckasin	bɛkkasiːn
beckasinsnäppa	bɛkkasiːnsnɛpa
bedrägeri	bɛdrɛːɡɛriː
begå	bəɡoː
behov	bɛhuːv
beige	beːɧ
bekant	bəkant
belgien	bɛlɡɪɛn
ben	beːn
berg	bɛrj
bergand	bɛrjand
bergen	bɛrjɛn
bergens	bɛrjɛns
berget	bɛrjɛt
bergets	bɛrjɛts
bergs	bɛrjs
bergsångare	bɛrjsɔŋarɛ
bergtajgasångare	bɛrjtajɡasɔŋarɛ
bergtita	bɛrjtiːta
berguv	bɛrjʉːv
berlin	berliːn
bert	bæʈ
beryllium	bɛrʏlɪɵm
besk	bɛsk
besked	bɛɧeːd
bespisa	bespiːsa
bespisning	bɛspiːsnɪŋ
bestrida	bɛstriːda
besvika	bɛsviːka
besökare	bɛsøːkarɛ
beta	bɛtɑː
betala	bɛtɑːla
bete	beːtɛ
beteende	bɛteːɛndɛ
betyda	bɛtyːda
betydelse	bɛtyːdɛlsɛ
bi	biː
biathlon	biːatlɔn
bikini	bɪkiːnɪ
bil	biːl
bilist	bɪlɪst
biljard	bɪljɑːrd
biljon	bɪljuːn
bill	bɪl
bilparkering	biːlparkeːrɪŋ
biologi	bɪʊlʊɡiː
birgitta	bɪrɡɪta
biskop	biskɔp
bit	biːt
bits	bɪts
bitvarg	biːtvarj
biätare	biːɛtarɛ
bjuda	bjʉːda
bjugg	bjɵɡ
bjöd	bjøːd
björn	bjøːrn
blad	blɑːd
blandinaviska	blandɪnɑːvɪska
blandning	blandniŋ
blankspola	blaŋkspuːla
bleck	blɛk
blev	bleːv
bli	bliː
blida	bliːda
block	blɔkk
blod	bluːd
blodröd	bluːdrøːd
blodtörst	bluːdtɵʂʈ
blodtörstig	bluːdtœʂʈɪɡ
blogg	blɔɡː
blomma	blʊma
blomqvist	blʊmkvɪst
blott	blɔt
bly	blyː
blyg	blyːɡ
bläck	blɛkk
bläs	blɛs
bläsand	blɛsand
bläsgås	blɛsɡoːs
blå	bloː
blåbär	bloːbɛːr
blåkråka	bloːkroːka
blåljus	bloːjʉːs
blåljuscentral	bloːjʉːsseːntrɑːl
blåljusfilter	bloːjʉːsfɪltɛr
blåljusfordon	bloːjʉːsfuːrduːn
blåljuspersonal	bloːjʉːspɛʂʊnɑːl
blåst	bloːst
blåtand	bloːtand
blått	blɔt
bo	buː
boden	buːdɛn
bodil	buːdɪl
boel	buːɛl
bog	buːɡ
bok	buːk
boka	buːka
bokhandel	buːkhandɛl
bokstav	buːkstɑːv
bolaget	buːlɑːɡɛt
bon	buːn
bondska	bʊndska
boning	buːnɪŋ
bop	bɔp
bor	boːr
bord	buːɖ
borde	buːɖə
bordsbön	buːrdsbøːn
bordtennis	buːɖtɛnɪs
boren	buːrɛn
bortaplan	bɔrtaplɑːn
bortskänka	bɔrtɧɛŋkɛs
borås	bʊroːs
bostad	buːstɑːd
bot	buːt
bota	bota
botar	buːtar
bov	buːv
bra	brɑː
braig	brɑːɪɡ
brand	brand
brandskatta	brandskatta
brasklapp	brasklap
bre	breː
brev	breːv
brevbärare	breːvbæːrare
brinna	brɪna
bris	briːs
brista	brɪsta
bro	bruː
bron	brɔn
brons	brɔns
bronsibis	brɔnsiːbɪs
bror	bruːr
brorsa	brʊʂa
bros	bruːs
broschyr	brʊɧyːr
brud	brʉːd
brun	brʉːn
brunand	brʉːnand
brunch	brɵnɧ
bruno	brʉːnʊ
brunsenap	brʉːnseːnap
brunsångare	brʉːnsɔŋarɛ
brus	brʉːs
brushane	brʉːshɑːnɛ
brygd	brʏɡd
brylling	brʏlɪŋ
brytning	bryːtnɪŋ
bröd	brøːd
bröt	brøːt
bu	bʉː
bud	bʉd
budgetpromenaden	bɵdjɛtprʊmɛnɑːdɛn
bulle	bɵlɛ
bunt	bɵnt
bur	bʉːr
burdus	bɵrdʉːs
buren	bʉːrɛn
bus	bʉːs
busig	bʉːsɪɡ
busksångare	bɵsksɔŋarɛ
buss	bɵs
bussarong	bɵsarɔŋ
busstation	bɵsstaɧuːn
bygd	bʏɡːd
bygga	bʏɡːa
byling	byːlɪŋ
byrå	byːrɔ
byte	byːtɛ
byxis	bʏksɪs
bäckna	bɛkkna
bältdjur	bɛltjʉːr
bäng	bɛŋ
bär	bɛːr
bärs	bærs
bärsa	bærsa
bävergäll	bɛːvɛrjɛl
båda	boːda
både	boːde
båge	boːɡɛ
bål	boːl
bår	boːr
båt	boːt
böcker	bøkkər
bödel	bøːdɛl
bög	bøːɡ
bögig	bøːɡɪɡ
café	kafeː
californium	kalɪfoːrnɪɵm
calla	koːla
calle	kalɛ
carina	kariːna
karl	kɑːrl
carpmes	karpmeːs
centimeter	sɛntɪmeːtɛr
centralort	sɛntrɑːlʊrt
cesium	seːsɪɵm
cettisångare	sɛtɪsɔŋarɛ
champagne	ɧampanj
champinjon	ɧampɪnjun
chans	ɧaŋs
chark	ɧark
charkuteri	ɧarkɵtɛriː
charlie	ɕɑːɭɪ
charlotta	ɧarɭota
charm	ɧarm
charmör	ɧarmɶːr
chef	ɧeːf
chef	ɧɛːf
choklad	ɧʊklɑːd
cineast	sɪneast
citron	sɪtruːn
clown	klaʊn
clownfisk	klaʊnfɪsk
container	kɔntɛjnɛr
cool	kuːl
croissant	krʊasaŋ
cup	kɵp
cyberattack	syːbɛratakk
cykel	syːkel
dadel	dɑːdɛl
dag	dɑːɡ
dags	dɑːɡs
dam	dɑːm
damm	dam
dammsnäppa	damsnɛpa
dan	dɑːn
danmark	danmark
dansk	dansk
danska	danska
danskjävel	danskjɛːvɛl
dativ	dɑːtiːv
dator	dɑːtʊr
de	deː
december	dɛsɛmbɛr
decennium	dɛsɛnɪɵm
decimeter	dɛsɪmeːtɛr
definition	dɛfɪnɪɧuːn
deg	deːɡ
dekameter	dɛkameːtɛr
dela	deːla
den	dɛn
denne	dɛnnɛ
dessa	dɛssa
dessutom	desʉːtɔm
det	deːt
detektiv	dɛtɛktiːv
detta	dɛtta
dig	dɛj
digitaliseringsminister	dɪɡɪtalɪseːrɪŋsmɪnɪstɛr
dimmig	dɪmmɪɡ
din	dɪn
ding	dɪŋ
dirr	dɪr
diskrepans	dɪskrɛpans
diskussion	dɪskɵɧuːn
djungel	djʉŋel
dock	dɔkk
dog	duːɡ
dogg	dɔɡ
doktor	dɔktɔr
dom	dʊm
dopparedagen	dɔparɛdɑːɡɛn
dopping	dɔpɪŋ
dos	duːs
dra	drɑː
dragen	drɑːɡɛn
dragon	draɡuːn
dragspel	drɑːɡspeːl
drake	drɑːkɛ
dras	drɑːs
dressing	dresiŋ
dricka	drɪkka
dricker	drɪkker
drillsnäppa	drɪlsnɛpa
driva	driːva
drivkraft	driːvkraft
drog	druːɡ
drogs	druːɡs
dromedar	drʊmɛdɑːr
droppen	drɔppɛn
dryg	dryːɡ
dränera	drɛneːra
dräng	drɛŋ
dröm	drœm
drös	drøːs
du	dʉː
dubbel	dɵbɛl
dubbelbeckasin	dɵbɛlbɛkkasiːn
dubbelgångare	dɵbɛlɡɔŋarɛ
dubiös	dɵbɪøːs
duk	dʉːk
dum	dɵm
dumbom	dɵmbʊm
dumhuvud	dɵmhɵvɵd
dun	dʉːn
dusch	dɵɧː
duscha	dɵɧa
dussin	dɵsɪn
dvärg	dvɛrj
dvärgalåt	dvɛrjaloːt
dvärgbeckasin	dvɛrjbɛkkasiːn
dvärgkanadagås	dvɛrjkanadaɡoːs
dvärgmus	dvɛrjmʉːs
dvärgmås	dvɛrjmoːs
dvärgskarv	dvɛrjskarv
dvärgspov	dvɛrjspuːv
dvärgsumphöna	dvɛrjsɵmphøːna
dvärgsångare	dvɛrjsɔŋarɛ
dygna	dʏŋna
dyr	dyːr
dysfori	dysfuriː
dysterkvist	dʏstɛrkvɪst
däka	dɛːka
där	dɛːr
då	doː
dålig	doːlɪɡ
dö	døː
död	døːd
döda	døːda
dödprat	døːdprɑːt
dölja	dœlja
ed	eːd
edvin	eːdvɪn
efor	efoːr
efter	ɛftɛr
eftersom	ɛftærsɔm
egentlig	ɛjɛntlɪɡ
egentligen	ɪjɛntlɪɡɛn
egg	ɛɡː
egga	ɛɡa
egypten	ɛjʏptɛn
einsteinium	ajnstajnɪɵm
ek	eːk
ekmes	eːkmeːs
eko	eːkʊ
ekollon	eːkɔlɔn
eksångare	eːksɔŋarɛ
el	eːl
elak	eːlɑːk
elcykel	eːlsʏkɛl
eld	ɛld
eldar	ɛldar
eldslandet	ɛldslandɛt
elefanta	ɛlɛfanta
elegant	ɛlɛɡant
elektron	ɛlɛktroːn
eleonorafalk	ɛlɛɔnoːrafalk
elfte	ɛlftɛ
eller	ɛlɛr
elva	ɛlva
emigrant	ɛmɪɡrant
emulera	ɛmɵleːra
en	ɛn
enastående	eːnastoːɛndɛ
enda	ɛnda
energi	ɛnərɧiː
enfaldig	eːnfaldɪɡ
engagemang	aŋɡaɧɛmaŋ
engagera	aŋɡaɧeːra
engelska	eŋelska
england	ɛŋland
enhetlig	eːnheːtlɪɡ
enkel	ɛŋkɛl
enkelbeckasin	ɛnkɛlbɛkkasiːn
ensam	ɛnsam
ensamhet	ɛnsamheːt
entusiasm	ɛntɵsɪasm
er	eːr
era	eːra
erbium	ɛrbɪɵm
erinra	eːrɪnra
erkänna	eːrɕɛna
erkänt	ɛːrɕɛnt
errata	erɑːta
esperanto	ɛspərantʊ
estniska	ɛstnɪska
ett	ɛt
europa	ɛruːpa
europium	ɛruːpɪɵm
eva	eːva
evelina	ɛvɛliːna
event	ɛvɛnt
excel	ɛksɛl
experiment	ɛkspɛrɪmɛnt
fabrik	fabriːk
fackverk	fakkvɛrk
fader	fɑːdɛr
falang	falaŋ
falla	falla
fallskärm	falɧɛrm
falsk	falsk
fan	faːn
far	fɑːr
farlig	fɑːrlɪɡ
fars	fɑːrs
fartkamera	fɑːʈkɑːmɛra
farväl	fɑːrvɛːl
fatabur	fɑːtabʉːr
fattig	fatɪɡ
februari	fɛbrɵɑːrɪ
fejs	fɛjs
fel	feːl
fem	fɛm
femtal	fɛmtɑːl
femte	fɛmtɛ
femtio	fɛmtɪʊ
femtiöring	fɛmtɪœːrɪŋ
femton	fɛmtɔn
fena	feːna
fest	fɛst
fet	feːt
fett	fɛt
fia	fiːa
ficka	fɪkka
fiende	fiːɛndɛ
fientlig	fɪɛntlɪɡ
figur	fɪɡʉːr
fik	fiːk
fika	fiːka
fikarast	fiːkarast
fil	fiːl
filippa	fɪlɪpa
filippintörnskata	fɪlɪpiːntøːrnskɑːta
filmatisera	fɪlmatɪseːra
filmjölk	fiːlmjœlk
filosofie	fɪlʊsʊfiːɛ
filosofisk	fɪlʊsoːfɪsk
fimpa	fɪmpa
fin	fiːn
final	fɪnɑːl
finger	fɪŋər
fingers	fɪŋɛrs
finland	fɪnland
finna	fɪna
finnjävel	fɪnjɛːvɛl
finska	fɪnska
firre	fɪrɛ
fisk	fɪsk
fiske	fɪskɛ
fisken	fɪskɛn
fiskens	fɪskɛns
fisktärna	fɪsktɛrna
fission	fɪɧuːn
fitta	fɪtta
fittig	fɪttɪɡ
fjantig	fjantɪɡ
fjol	fjuːl
fjompig	fjɔmpɪɡ
fjor	fjuːr
fjord	fjuːrd
fjortis	fjuːʈɪs
fjorton	fjuːʈɔn
fjällabb	fjɛllab
fjällgås	fjɛlɡoːs
fjällpipare	fjɛlpiːparɛ
fjällripa	fjɛlriːpa
fjälluggla	fjɛlɵɡla
fjärd	fjæːɖ
fjärde	fjɛːrdɛ
fjäril	fjɛːrɪl
fjärt	fjæʈ
flarra	flara
flata	flɑːta
fleece	fliːs
flicka	flɪkka
flickan	flɪkkan
flickor	flɪkkʊr
flod	fluːd
flodvåg	fluːdvoːɡ
flottningsmärke	flɔttnɪŋsmɛrkɛ
flummig	flɵmɪɡ
fluor	floːr
flygskam	flyːɡskam
flyktig	flʏktɪɡ
flyta	flyːta
flytta	flʏtta
fläckdrillsnäppa	flɛkkdrɪlsnɛpa
flå	floː
flår	floːr
flöte	fløːtɛ
focka	fɔkka
folkmusik	fɔlkmɵsiːk
folköl	fɔlkøːl
fonetik	fɔnetiːk
formation	fɔrmaɧuːn
fors	fɔʂ
forstmästare	fɔrstmɛstarɛ
forstväsen	fɔrstveːsen
fort	fʊʈ
fosfor	fɔsfɔr
foster	fʊstɛr
fosterland	fʊstærland
fot	fuːt
fotboll	fuːtbɔl
fotnot	fuːtnuːt
foula	faʊla
foxtrot	fɔkstrɔt
frakt	frakt
fram	fram
framför	framfœːr
fransk	fransk
franska	franska
fred	freːd
fredag	freːdɑːɡ
fredrika	freːdriːka
freestyle	friːstajl
fri	friː
frid	friːd
friggebod	frɪɡɛbuːd
frihet	friːheːt
fritis	friːtɪs
fru	frʉː
frugge	frɵɡɛ
frukt	frɵkt
frunch	frɵnɧ
frys	fryːs
främlingsfientlig	frɛmlɪŋsfɪɛntlɪɡ
främlingsfientlighet	frɛmlɪŋsfɪɛntlɪɡheːt
främmat	frɛmat
frände	frɛndɛ
fråga	froːɡa
från	froːn
frånvaro	froːnvɑːrʊ
frö	frøː
fröjd	frœjd
fröken	frøːkɛn
frös	frøːs
fubbick	fɵbɪkk
ful	fʉːl
full	fɵl
fungera	fɵŋɡeːra
funka	fɵŋka
funktion	fɵŋkɧuːn
funktionell	fɵŋkɧʊnɛl
fur	fʉːr
furnera	fɵrneːra
fusion	fɵɧuːn
fusk	fɵsk
futurum	fɵtʉːrɵm
fy	fyː
fyn	fyːn
fynd	fʏnd
fyr	fyːr
fyra	fyːra
fyrmänning	fyːrmɛnɪŋ
fyrtal	fyːrtɑːl
fyrtio	fœrtɪʊ
fyrtio	fœrtɪ
fä	fɛː
fäbod	fɛːbuːd
fälad	fɛːlɑːd
fältsångare	fɛltsɔŋarɛ
fän	fɛːn
fänkål	fɛːnkoːl
fänrik	fɛnrɪk
färg	fɛrj
färsk	fɛrsk
färskvatten	fɛrskvatɛn
fäst	fɛst
få	foː
fågel	foːɡəl
får	foːr
fåraherde	foːraheːrdɛ
fårakläder	foːraklɛːdɛr
fåtal	foːtɑːl
fåtölj	fɔtœlj
föda	føːda
född	fœd
födelsedag	føːdɛlsɛdɑːɡ
fönster	fœnstɛr
för	føːr
förbruka	fœrbrʉːka
förbud	fœrbʉːd
förbundskapten	fœrbɵndskapteːn
förbutik	føːrbʉːtiːk
fördriva	fœrɖriːva
fördöma	fɵrdɵma
före	føːrɛ
förebrå	føːrɛbroː
föregångare	føːrɛɡɔŋarɛ
förena	fœreːna
förening	fœreːnɪŋ
förete	føːrɛteː
förgänglig	fœrjɛŋlɪɡ
förgäves	fœrjɛːvɛs
förnuftig	fœɳɵftiɡ
förrän	fœrɛn
försiktighet	føːrsɪktɪɡheːt
förskolelärare	føːrskuːlɛlɛːrarɛ
förskräcklig	fœrskrɛkklɪɡ
förstå	fœrstoː
förstås	fɶʂtoːs
förstöra	fœʂʈœːra
försvarare	føːrsvɑːrarɛ
försvarstal	fœrsvɑːrstɑːl
försöka	fœrsøːka
förträfflig	fœrʈrɛflɪɡ
förut	fœrʉːt
förvirring	føːrvɪrɪŋ
förälder	fœrɛldær
förälskad	fœrɛlskad
förälskelse	fœrɛlskɛlsɛ
gabbe	ɡabbɛ
gabriel	ɡabriel
gadd	ɡad
gaffel	ɡaffɛl
galax	ɡalaks
galär	ɡalɛr
gammal	ɡammal
gamme	ɡamɛ
gammeldans	ɡamɛldans
gammelgädda	ɡamɛljɛda
gammelmedia	ɡamɛlmeːdɪa
garanti	ɡarantɪ
gas	ɡɑːs
gata	ɡɑːta
gav	ɡɑːv
ge	jeː
gem	jeːm
gemen	jɛmeːn
gen	jeːn
general	jɛnɛrɑːl
genitiv	jeːnɪtiːv
genom	jeːnɔm
genrep	jeːnreːp
genrer	jaŋrar
genrerna	jaŋrarna
gentil	jaŋtiːl
georg	jeːɔrj
ger	jeːr
germanium	jɛrmɑːnɪɵm
gert	jæʈ
gest	jɛst
get	jeːt
geting	jeːtɪŋ
getruta	jeːtrʉːta
geväder	jɛvɛːder
gevär	jɛvɛːr
gick	jɪkk
gifter	jɪftɛr
giftig	jɪftɪɡː
gin	jɪn
gipsplatta	jɪpsplata
gipsskiva	jɪpsɧiːva
gir	jiːr
giraff	ɧɪraf
gita	jiːta
gitarr	jɪtar
gitta	jɪta
giva	jiːva
gjord	jʊɖː
gjorde	jʊɖɛ
gjort	jʊʈ
gjuta	jʉːta
glad	ɡlɑːd
gladlynt	ɡlɑːdlʏnt
glas	ɡlɑːs
glashus	ɡlɑːshʉːs
glasmästarsill	ɡlɑːsmɛstarsɪl
glass	ɡlas
glassmaskin	ɡlasmaɧiːn
glatt	ɡlat
gluttsnäppa	ɡlɵtsnɛpa
glögg	ɡlœɡ
gnag	ɡnɑːɡ
gned	ɡneːd
gnid	ɡniːd
gnids	ɡniːds
god	ɡuːd
goddag	ɡʊddɑːɡ
golv	ɡɔlv
gott	ɡɔt
gradu	ɡrɑdʉ
gran	ɡrɑːn
gransångare	ɡrɑːnsɔŋarɛ
grattis	ɡratɪs
gratäng	ɡratɛŋ
grav	ɡrɑːv
gravand	ɡrɑːvand
gravitation	ɡravɪtaɧuːn
gravlax	ɡrɑːvlaks
green	ɡriːn
grej	ɡrɛj
grekland	ɡreːkland
grep	ɡreːp
grina	ɡriːna
grip	ɡriːp
groda	ɡruːda
gross	ɡrɔs
grov	ɡruːv
grund	ɡrɵnd
grym	ɡrʏm
grymta	ɡrʏmta
gryning	ɡryːnɪŋ
gryta	ɡryːta
gräddbulle	ɡrɛdbɵlɛ
gräddfil	ɡrɛddfiːl
gräsand	ɡrɛːsandand
grät	ɡrɛːt
gråben	ɡroːbeːn
grågam	ɡroːɡɑːm
grågås	ɡroːɡoːs
gråhakedopping	ɡroːhɑːkɛdɔpɪŋ
gråhäger	ɡroːhɛɡɛr
gråspett	ɡroːspɛt
gråsäl	ɡroːsɛːl
gråt	ɡroːt
gråtrut	ɡroːtrʉːt
grön	ɡrøːn
grönbena	ɡrøːnbeːna
grönkål	ɡrøːnkoːl
grönsångare	ɡrøːnsɔŋarɛ
gröt	ɡrøːt
gubbe	ɡɵbɛ
gud	ɡʉːd
guding	ɡʉːdɪŋ
guds	ɡɵts
gul	ɡʉːl
gula	ɡʉːla
guld	ɡɵld
gullgosse	ɡɵlɡɔsɛ
gullviva	ɡɵlviːva
gump	ɡɵmp
gungfly	ɡɵŋflyː
gurra	ɡɵrra
guss	ɡɵs
gym	jʏm
gymma	jʏmma
gymnasium	jʏmnɑːsɪɵm
gyros	jyːrʊs
gäl	jɛːl
gäri	jɛːrɪ
gärna	jɛːrna
gäst	jɛst
gästfri	jɛstfriː
gästfrihet	jɛstfriːheːt
gästgiveri	jæstjiːvɛriː
gävle	jɛːvlɛ
gå	ɡoː
gång	ɡɔŋ
gången	ɡɔŋen
gången	ɡɔŋen
gångjärn	ɡɔŋjɛːrn
gård	ɡoːrd
gås	ɡoːs
gåskarl	ɡoːskɑːr
gåstol	ɡoːstuːl
gått	ɡɔt
gök	jøːk
göktyta	jøːktyːta
göl	jøːl
göra	jøːra
göran	jøːran
gördel	jœrjdɛl
göt	jøːt
göteborg	jœtɛbɔrj
göteborgska	jœtebɔrjska
gött	jœt
ha	hɑː
hade	haddɛ
haft	haft
hage	hɑːɡɛ
hagtorn	haktuːrn
haj	haj
hall	hal
hallon	halɔn
hallå	haloː
halmbock	halmbɔkk
halv	halv
halvlek	halvleːk
hambo	hambʊ
han	han
hand	hand
handikapp	handɪkap
handskrift	handskrɪft
handtryck	handtrʏkk
hans	hɑːns
hantverk	hantvɛrk
har	hɑːr
hara	hɑːra
hat	hɑːt
hata	hataː
hatt	hat
hav	hɑːv
havre	hɑːvrɛ
havssula	havsʉːla
havstrut	havstrʉːt
havsörn	havsøːrn
heat	hiːt
hej	hɛjj
hekto	hɛktʊ
hel	heːl
helg	hɛlj
helga	hɛlɡa
helig	heːlɪɡ
helium	heːlɪɵm
helsingborg	hɛlsɪŋbɔrj
helsingfors	hɛlsɪŋfɔrs
helsingör	hɛlsɪŋøːr
helvete	hɛlvɛtɛ
hem	hɛm
hembränd	hɛmbrɛnd
hembränt	hɛmbrɛnt
hemester	hɛmɛstɛr
hemläxa	hɛmlɛksa
hemmaplan	hɛmmaplɑːn
hemul	hemʉːl
hen	hɛn
henne	hɛnnɛ
henom	hɛnɔm
hens	hɛns
herbert	hærbæʈ
herdestund	heːrdɛstɵnd
herr	hɛr
herre	hɛrrɛ
hertz	hærts
het	heːt
heta	heːta
hetvägg	heːtvɛɡ
hia	hiːa
hialös	hiːaløːs
himalaya	hɪmɑːlaja
himalayagyllenmes	himɑːlɪjajʏlɛnmeːs
hinsidan	hiːnsiːdan
hispa	hɪspa
hispig	hɪspɪɡ
hitta	hɪta
hjord	juːɖ
hjort	jʊrt
hjorta	jʊrta
hjortron	jʊʈrɔn
hjul	jʉːl
hjälm	jɛlm
hjälp	jɛlp
hjälpa	jɛlpa
hjälte	jɛltɛ
hjärna	jɛːɳa
hjärta	jɛrta
hjärtinfarkt	jɛrtɪnfarkt
hjärtlig	jæʈlɪɡ
hockeyfrilla	hɔkkʏfrɪla
holm	hɔlmɛ
homofili	humufiliː
homosex	huːmʊseks
hon	hʊn
honom	hɔnɔm
honung	hoːnɵŋ
hoppa	hɔpa
hoppeligen	hɔpɛliːɡɛn
hor	huːr
hornuggla	hʊrnɵɡla
horoskop	hʊrʊskoːp
hos	huːs
hotell	hʊtɛl
hov	huːv
hud	hʉːd
huddinge	hɵddɪŋɛ
hudsonspov	hɑdsɔnspuːv
huggmejsel	hʊɡmɛjsɛl
humle	hɵmlɛ
hund	hɵnd
hundra	hɵndra
hungrig	hɵŋrɪɡ
hur	hʉːr
hurring	hɵrɪŋ
hus	hʉːs
husdjur	hʉːsjʉːr
husmanskost	hʉːsmanskɔst
hussvala	hʉːssvɑːla
huv	hʉːv
huvud	hʉːvɵd
huvudspråk	hʉːvɵdsproːk
hyf	hyːf
hygglig	hʏɡlɪɡ
hylla	hʏlla
hyperdrift	hyːpɛrdrɪft
hyrkanmes	hʏrkanmeːs
häftig	hɛftɪɡ
hägna	hɛŋna
häl	hɛːl
häll	hɛl
hällregn	hɛlrɛŋn
här	hæːr
häradshövding	hæːradshœvdɪŋ
häradsrätt	hæːradsrɛt
härför	hæːrføːr
härk	hɛrk
härlig	hɛːrlɪɡ
härmsångare	hɛrmsɔŋarɛ
härold	hɛːrɔld
håg	hoːɡ
håla	hoːla
håna	hoːna
hår	hoːr
hårdrockare	hoːrdrokkarɛ
hårt	hoːʈ
håv	hoːv
hö	høː
höbal	høːbɑːl
hög	høːɡ
höga	høːɡa
högkvarter	høːɡkvarteːr
högljudd	høːɡjɵd
högljutt	høːɡjɵt
högsvenska	høːɡsvenskɑ
högtid	høːɡtiːd
hök	høːk
hölja	hœlja
höna	høːna
höra	høːra
höst	hœst
höstas	hœstas
höstdagjämning	hœstdɑːɡjɛmnɪŋ
idissla	iːdɪsla
idrott	iːdrɔt
igelkott	iːɡɛlkɔt
igenom	ɪjeːnɔm
ignorera	ɪŋnʊreːra
ihjäl	ɪjɛːl
ihop	ɪhuːp
ikea	ɪkeːa
illamående	ɪlamoːɛndɛ
illusion	ɪlɵɧuːn
imperfekt	ɪmpɛrfɛkt
in	ɪn
inandning	ɪnandnɪŋ
inbjudan	ɪnbjʉːdan
indian	ɪndɪɑːn
infinitiv	ɪnfɪnɪtiːv
inga	ɪŋa
ingendera	ɪŋɛndeːra
ingenjör	ɪnɧɛnjøːr
ingenting	ɪŋɛntɪŋ
inger	ɪnjeːr
inkapabel	ɪnkapɑːbɛl
inn	ɪn
innan	ɪnan
innanför	ɪnanføːr
insexnyckel	ɪnsɛksnʏkkɛl
insjukna	ɪnɧʉːkna
inspektion	ɪnspɛkɧuːn
instruktion	ɪnstrɵkɧuːn
inte	ɪntɛ
integral	ɪntɛɡraːl
internationell	ɪntɛrnatɧʊnɛl
internet	ɪntɛrnɛt
intervju	ɪntɛrvjʉː
intryck	ɪntrʏkk
intyg	ɪntyːɡ
invändig	ɪnvɛndɪɡ
iriomotemes	ɪrɪjɔmɔtɛmeːs
irland	ɪrland
irra	ɪrra
is	iːs
isabella	ɪsabɛla
isabellatörnskata	ɪsabɛlatøːrnskɑːta
ismås	iːsmoːs
israel	ɪsraeːl
italien	ɪtɒːlɪən
ivar	iːvar
ja	jɑː
jacka	jakka
jacke	jakkɛ
jag	jɑːɡ
jaga	jɑːɡa
jak	jɑːk
jaktfalk	jaktfalk
jalla	jalla
jalusi	ɧalɵsiː
jam	jɑːm
januari	janɵɑːrɪ
japan	japɑːn
japanare	japɑːnarɛ
japansk	japɑːnsk
japanska	japɑːnska
jargong	jarɡɔŋ
jasmine	jasmiːn
jason	jɑːsɔn
jennie	jɛnɪ
jenny	jɛnʏ
jerusalem	jɛrʉːsalɛm
jesuit	jɛsʉiːt
jesus	jeːsɵs
jiddra	jɪdra
jo	juː
jocke	jʊkkɛ
jod	jɔd
johan	jʊan
johanna	jʊhana
joint	jɔɪnt
jojk	jɔjk
jojka	jɔjka
jojo	jʊjʊ
jokk	jɔk
jolle	jɔllɛ
jonas	juːnas
jonsson	jʊnsɔn
jonte	jɔntɛ
joppe	jɔppe
jord	juːrd
jordafärd	juːrdafɛːrd
jorden	juːrdɛn
jordgubbe	juːɖɡɵbɛ
jorduggla	jʊrdɵɡla
jordvarg	juːɖvarj
jota	juːta
journalist	jʊrnajlɪst
jox	jʊks
ju	jɵ
judetyska	jʉːdɛtʏska
juice	juːs
jul	jʉːl
julas	jʉːlas
julgranskula	jʉːlɡrɑːnskʉːla
juli	jʉːlɪ
julmust	jʉːlmɵst
jungfrukälla	jʉŋfrʉːɕɛla
jungfrutrana	jɵŋfrɵtrɑːna
juni	jʉːnɪ
jupiter	jypitɛr
jury	jɵrʏ
juver	jʉvɛr
jägmästare	jɛːɡmɛstarɛ
jämte	jɛmtɛ
järn	jɛːrn
järnvägsstation	jæːɳvɛːɡsstaɧuːn
järpe	jɛrpɛ
järv	jærv
jäst	jɛst
jävel	jɛːvɛl
jävig	jɛːvɪɡ
jönköping	jœnɕøːpɪŋ
kackig	kakkɪɡ
kadmium	kadmɪɵm
kaffe	kaffɛ
kaffegök	kaffejøːk
kaffepumla	kafɛpɵmla
kafe	kafeː
kajak	kajɑːk
kaka	kɑːka
kakao	kɑːkaʊ
kal	kɑːl
kalabalik	kalabaliːk
kalcium	kalsɪɵm
kalifornien	kalɪfuːrnɪɛn
kalium	kɑːlɪɵm
kalk	kalk
kalkon	kalkuːn
kall	kal
kalla	kalla
kalle	kallɛ
kallprat	kalprɑːt
kalmarit	kalmariːt
kam	kam
kamera	kɑːmɛra
kan	kɑn
kanadagås	kanadaɡoːs
kanadames	kanadameːs
kanadensisk	kanadɛnsɪsk
kanelbulle	kaneːlbɵllɛ
kanelsnäcka	kaneːlsnɛkka
kanot	kanuːt
kanske	kanɕɛ
kaos	kaʊs
kapmes	kɑːpmeːs
kappa	kappa
kar	kɑːr
karbin	karbiːn
kardinal	kaɖɪnɑːl
karina	kariːna
karl	kɑːrl
karolina	karʊliːna
karolinasumphöna	karʊliːnasɵmphøːna
karolinatita	karʊliːnatiːta
karta	kɑːrta
kasse	kassɛ
kasus	kɑːsɵs
katarina	katariːna
katod	katuːd
katrina	katriːna
katt	kat
kedja	ɕeːdja
keff	ɕɛf
kejsarörn	ɕɛjsarøːrn
kemi	ɕɛmiː
keramik	ɕɛramiːk
kerstin	ɕæʂtɪn
kex	ɕɛks
kika	ɕiːka
kil	ɕiːl
kille	ɕɪllɛ
kilo	ɕiːlʊ
kilometer	ɕɪlʊmeːtɛr
kina	ɕiːna
kind	ɕɪnd
kinders	ɕɪndɛrs
kines	ɕɪneːs
kinesa	ɕɪneːsa
kinesisk	ɕɪneːsɪsk
kinesiska	ɕɪneːsɪska
kiosk	ɕɔsk
kioskmongo	ɕɔskmɔŋɡʊ
kioskvältare	ɕoskvɛltarɛ
kirra	ɕɪra
kirurg	ɕɪrɵrɡ
kisel	ɕiːsɛl
kista	ɕɪsta
kittel	ɕɪtɛl
kjell	ɕɛl
kjellberg	ɕɛlbærj
kjol	ɕuːl
kladdkaka	kladkɑːka
klandra	klandra
klar	klɑːr
klarhet	klɑːrheːt
klinga	klɪŋa
klingonska	klɪŋɔnska
klintbergare	kliːntbɛːrjareː
klippduva	klɪpdʉːva
klippkaja	klɪpkaja
klippsvala	klɪpsvɑːla
klittra	klɪtra
klocka	klɔkka
klon	kluːn
klonken	klɔŋkɛn
klor	kluːr
kläde	klɛːdɛ
kläder	klɛːdɛr
klädhängare	klɛdhɛŋarɛ
klå	kloː
klår	kloːr
klökas	kløːkas
klösa	kløːsa
klövdjur	kløːvjʉːr
knaffel	knaffɛl
knapp	knap
knappologi	knapʊlʊɡiː
knark	knark
knarka	knarka
kned	kneːd
kniv	kniːv
knoparmoj	knuːparmɔj
knubbsäl	knɵbsɛːl
knulla	knɵlla
knut	knʉːt
knuten	knʉːtɛn
knä	knɛː
knåda	knoːda
knö	knœː
knöl	knøːl
knölsvan	knølsvɑːn
knölsvärta	knølsvɛʈa
ko	kuː
kobolt	kuːbɔlt
koboltmes	kuːbɔltmeːs
kod	kuːd
kofta	kɔfta
kolla	kɔla
kolymasnäppa	kɔlyːmasnɛpa
kom	kɔm
komma	koma
kommer	kɔmmɛr
kompis	kɔmpɪs
komplett	kɔmplɛt
kon	kuːn
konflikt	kɔnflɪkt
konst	kɔnst
konstbefrukta	kɔnstbɛfrɵkta
konstbevattna	kɔnstbɛvatna
konstbevattning	kɔnstbɛvatnɪŋ
konstfiber	kɔnstfiːbɛr
konstgjord	kɔnstjuːrd
konstläder	kɔnstlɛːdɛr
kontra	kɔntra
kontrast	kʊntrast
konung	koːnɵŋ
konungarike	koːnɵŋariːkɛ
kopia	kʊpiːa
kopp	kɔp
koppar	kɔpar
kopparand	kɔparand
koppling	kɔplɪŋ
kopplingskåpa	kɔplɪŋskoːpa
kor	kuːr
korea	kʊreːa
korean	kʊreːaːn
korg	kɔrj
kornknarr	kuːɳknar
korp	kɔrp
korshänvisning	kɔrshɛːnviːsnɪŋ
kort	kʊrt
korttålärka	kɔrtoːlɛrka
kost	kɔst
kostpris	kɔstpriːs
koxik	kʊksɪk
koyot	kʊjoːt
krabba	krabba
krabbis	krɑbbis
kraftfull	kraftfɵl
kragtrapp	krɑːɡtrap
kran	krɑːn
krans	krans
krav	krɑːv
kretensisk	krɛtɛnsɪsk
kretsschema	krɛtsɧeːma
krig	kriːɡ
kristianstad	krɪɧansta
kristina	krɪstiːna
krita	kriːta
krog	kruːɡ
krokan	kroːkɑːn
krokben	kruːkbeːn
krom	kroːm
krona	kruːna
kronor	kruːnʊr
kropp	krɔp
kruka	krʉːka
krusbär	krʉːsbɛːr
krut	krʉːt
kräftskiva	krɛftɧiːva
kröka	krøːka
kuba	kʉːba
kudde	kɵddɛ
kuf	kʉːf
kuk	kʉːk
kuksugare	kʉːksʉːɡarɛ
kul	kʉːl
kuling	kʉːlɪŋ
kull	kɵl
kulör	kɵløːr
kunde	kɵndə
kung	kɵŋ
kungsfiskare	kɵŋsfɪskarɛ
kungsfågel	kɵŋsfoːɡɛl
kungsfågelsångare	kɵŋsfoːɡɛlsɔŋarɛ
kunna	kɵna
kur	kʉːr
kurr	kɵr
kurs	kʉːrs
kuse	kʉːsɛ
kusin	kɵsiːn
kustlabb	kɵstlab
kustpipare	kɵstpiːparɛ
kustsnäppa	kɵstsnɛpa
kut	kʉːt
kuta	kʉːta
kuttrasju	kɵtraɧʉː
kuvert	kɵvɛːr
kvalitet	kvalɪteː
kvar	kvɑːr
kvarg	kvarj
kvart	kvɑːrt
kvarter	kvarteːr
kvasar	kvasɑːr
kvicksilver	kvɪkksɪlvɛr
kvinna	kvɪnna
kvinnan	kvɪnnan
kvinnans	kvinnans
kvinnas	kvinnas
kvinnor	kvɪnnʊr
kvinnornas	kvinnʊɳas
kvinnors	kvinnʊʂ
kvist	kvɪst
kvitta	kvɪtta
kvälja	kvɛlja
kväll	kvɛl
kvänska	kvɛːnska
kväve	kvɛːvɛ
kyckling	ɕʏkklɪŋ
kyrka	ɕʏrka
kysk	ɕʏsk
kyskhet	ɕʏskheːt
kyss	ɕʏs
kyssa	ɕʏsa
käck	ɕɛkk
käftis	ɕɛftɪs
käk	ɕɛːk
käka	ɕɛːka
käke	ɕɛːkɛ
källa	ɕɛla
källare	ɕɛlarɛ
källing	ɕɛlɪŋ
känd	ɕɛnd
känga	ɕɛŋa
känguru	ɕɛŋɡɵrɵ
känna	ɕɛnna
kännspak	ɕɛnspɑːk
känsla	ɕɛnsla
känt	ɕɛnt
käpp	ɕɛp
kär	ɕɛːr
kära	ɕɛːra
kärl	ɕɛːrl
kärlek	ɕɛːrleːk
kärrhök	ɕɛrhøːk
kärrsnäppa	ɕɛrsnɛpa
kärrsångare	ɕɛrsɔŋarɛ
kärrtärna	ɕɛrtɛrna
kå	koː
kåda	koːda
kåk	koːk
kål	koːl
kålrabbi	koːlrabɪ
kår	koːr
kåt	koːt
kåta	koːta
kö	køː
köa	køːa
kök	ɕøːk
kökkenmödding	kœkɛnmœdɪŋ
köl	ɕøːl
kölna	ɕøːlna
kön	ɕøːn
köp	ɕøːp
köpa	ɕøːpa
köpenhamn	ɕøːpɛnhamn
köpstad	ɕøːpstɑːd
kör	ɕœːr
köra	ɕœːra
körandas	køːrandas
körandning	køːrandnɪŋ
kött	ɕœt
köttbullar	ɕœttbɵlar
köttbulle	ɕœttbɵlɛ
köttig	ɕœttɪɡ
köttslig	ɕœtslɪɡ
la	lɑː
laboratorium	labʊratuːrɪɵm
lade	lɑːdɛ
ladugård	lɑːdɵɡoːɖ
lag	lɑːɡ
lager	lɑːɡɛr
lagom	lɑːɡɔm
lagt	lakt
lagts	lakts
lagård	lɑːɡɔɖ
laholm	lahɔlm
laja	laja
lajbans	lajbans
lakan	lɑːkan
lakrits	lakrɪts
lamm	lam
lammgam	lamɡɑːm
lammkött	lammɕœt
land	land
landkrabba	landkrabba
landskapsdjur	landskɑːpsjʉːr
landskronit	landskrʊniːt
lantbrevbärare	lantbreːvbɛːrarɛ
lanterna	lantæːɳa
lappmes	lapmeːs
lappuggla	lapɵɡla
larv	larv
lasagne	lasanj
lastförskjutningsnät	lastføːrɧʉːtnɪŋsnɛːt
lattja	latɕa
lattjo	latɕʊ
lavoar	lavʊɑːr
lavskrika	lɑːvskriːka
lax	laks
layout	lɛjaʊt
le	leː
lealös	leːaløːs
leddjur	leːdjʉːr
ledig	leːdɪɡ
ledsen	lɛdsən
ledsna	lɛsna
leende	leːɛndɛ
legend	leɡend
legitim	lɛɡɪtiːm
lego	leːɡu
leidenflaska	lɛjdɛnflaska
leif	lɛjf
lek	lɛk
lemur	lɛmʉːr
lesbisk	lɛsbɪsk
less	lɛs
lettiska	lɛtɪska
lev	leːv
leva	leːva
leverpastej	leːvɛrpastɛj
lian	liaːn
lie	liːɛ
lik	liːk
liksom	lɪksɔm
lillejulafton	lɪlɛjʉːlaftɔn
lima	liːma
lin	liːn
lina	liːna
lindgren	lɪndɡreːn
lingon	liŋon
lingonsylt	lɪŋɔnsʏlt
linnea	lɪneːa
lisa	liːsa
lisas	liːsas
lita	liːta
liten	liːtɛn
litium	liːtsɪɵm
liv	liːv
livsfientlig	liːvsfɪɛntlɪɡ
livskvalitet	liːvskvaliteːt
ljud	jʉːd
ljuga	jʉːɡa
ljungby	jɵŋbʏ
ljungpipare	jɵŋpiːparɛ
ljus	jʉːs
ljushyllt	jʉshʏlt
ljuta	jʉːta
lo	luː
lob	luːb
lodjur	luːjʉːr
loge	luːɡɛ
lom	lʊm
london	lɔndɔn
lopp	lɔp
lov	luːv
lucia	lɵsiːa
luden	lʉːdɛn
lugn	lɵŋn
lunch	lɵnɧ
lunchdisco	lɵɧdɪskʊ
lunchrast	lɵnɧrast
lund	lɵnd
lundensisk	lɵndɛnsɪsk
lundgren	lɵndɡreːn
lundsångare	lɵndsɔŋarɛ
lungödem	lɵŋødeːm
lussekatt	lɵsɛkat
lycka	lʏkka
lycklig	lʏkklɪɡ
lyckt	lʏkkt
lyckta	lʏkkta
lydnad	lyːdnad
lykta	lʏkta
lymfocyt	lʏmfʊsyːt
lyssna	lʏsna
lyxhotell	lʏkshʊtɛl
läcka	lɛkka
läder	lɛːdɛr
läger	lɛːɡɛr
lägga	lɛɡa
län	lɛːn
länge	lɛŋɛ
längs	lɛŋs
lär	lɛːr
lära	læːra
läs	lɛːs
läsa	lɛːsa
läser	lɛsɛr
läsesal	lɛːsɛsɑːl
läsk	lɛsk
läska	lɛska
läsuttal	lɛːsʉttɑːl
lätt	lɛt
lätting	lɛtɪŋ
låg	loːɡ
långsam	lɔŋsam
långt	lɔŋt
långtåsnäppa	lɔŋtoːsnɛpa
långvarig	lɔŋvɑːrɪɡ
låt	loːt
låta	loːta
lögn	lœŋn
lök	løːk
lön	løːn
löneslav	løːnɛslɑːv
lönndom	lœndʊm
löpa	løːpa
lördag	løːrdɑːɡ
lös	løːs
lösa	løːsa
lösen	løːsɛn
lövverk	løːvvɛrk
mack	makk
macka	makka
mage	mɑːɡɛ
magnesium	maŋneːsɪɵm
magnoliaskogssångare	maɡnuːlɪjasɡʊɡsɔŋarɛ
magnus	maŋnɵs
maj	maj
majoritet	majorɪteːt
maka	mɑːka
maka	maka
make	mɑːkɛ
mal	mɑːl
malaria	malɑːrɪa
malin	maːlɪn
malin	maliːn
malin	maliːn
mall	mal
mallis	malɪs
malmö	malmøː
malmöit	malmøiːt
malte	maltɛ
malört	mɑːlœrt
mambo	mambʊ
man	mɑːn
mandrom	mandrɔm
manen	mɑːnən
manet	maneːt
manga	maŋɡa
mangan	maŋɡɑːn
mango	maŋɡʊ
manick	manɪkk
mannen	mannɛn
manöver	manøːvɛr
margareta	marɡareːta
margarin	marɡariːn
maria	mariːa
marika	mariːka
mark	mark
marknaden	marknadɛn
mars	maʂ
masa	mɑːsa
maskros	maskruːs
masktörnskata	masktøːrnskɑːta
massa	massa
mat	mɑːt
matcha	matɕa
matematik	matɛmatiːk
matsäck	mɑːtsɛkk
matt	mat
mattant	mɑːttant
mattias	matiːas
meckig	mekkɪɡ
med	meːd
medarbetare	meːdarbeːtarɛ
meddela	meːddela
meddelande	meːddeːlandɛ
medelhavstrut	meːdɛlhavstrʉːt
medhjälpare	meːdjɛlpare
medicin	mɛdɪsiːn
megafon	mɛɡafoːn
mejsel	mɛjsɛl
mem	meːm
meningslös	meːnɪŋsløːs
meningslösa	meːnɪŋsløːsa
mens	mɛns
mentalesiska	mɛntaleːsɪska
meny	mɛnyː
mer	meːr
merkurius	mɛrkʉːrɪɵs
mes	meːs
messmör	meːssmøːr
metan	mɛtɑːn
meter	meːtɛr
metonym	mɛtʊnyːm
meänkieli	meːɛnkɪɛlɪ
middag	mɪdɑːɡ
midsommar	mɪdsɔmar
mikael	miːkaːel
miklagård	miːklaɡoːrd
mil	miːl
mildra	mɪldra
miljard	mɪljɑːɖ
miljon	mɪljuːn
miljö	mɪljøː
millimeter	mɪlɪmeːtɛr
min	miːn
mina	miːna
mineral	minɛraːl
minikjol	miːnɪɕuːl
ministerstyre	mɪnɪstɛrstyːrɛ
minnesgod	mɪnɛsɡuːd
miombomes	mɪjɔmbɔmeːs
mission	mɪɧuːn
mitt	mɪt
mittemot	mɪtemuːt
mjöd	mjøːd
mjölk	mjœlk
mjölner	mjœlnir
mod	muːd
mode	muːdɛ
modevisning	muːdɛviːsnɪŋ
mojäng	mʊjɛŋ
moll	mɔl
moln	mɔln
molybden	mɔlʏbdeːn
monaco	mɔnakʊ
mongo	mɔŋɡʊ
mongolpipare	mɔŋɡʊlpiːparɛ
monoteist	mɔnʊtɛɪst
monument	moːnɵmɛnt
mor	muːr
morbror	mʊrbrʊr
mord	muːɖ
morgnar	moːrnar
morgnarna	moːɳaɳa
morgon	mɔrɡɔn
morkulla	muːrkɵla
mors	muːrs
morsa	mʊʂa
morsning	mɔrsnɪŋ
mos	muːs
moskva	mʊskvɑː
mosnäppa	muːsnɛpa
moster	mʊstɛr
mot	muːt
motgift	muːtjift
motorcykelhjälm	muːtɔrsʏkɛljɛlm
motsade	muːtsɑːdɛ
muck	mɵkk
mujka	mʉjkɑ
mula	mʉːla
mull	mɵl
mumie	mʉːmɪɛ
mumrik	mɵmrɪk
mun	mɵn
mundiarré	mɵndɪareː
mur	mʉːr
murpelare	mʉːrpeːlare
mus	mʉːs
museer	mɵseːɛr
museum	mɵseːɵm
musik	mʉsiːk
muskedunder	mɵskɛdɵndɛr
muslim	mɵsliːm
musseron	mɵsɛrɔn
must	mɵst
mycket	mʏkkɛt
mygga	mʏɡa
myla	myːla
mynning	mʏnnɪŋ
mynt	mʏnt
myrsnäppa	myrsnɛpa
myrspov	myːrspuːv
mys	myːs
mysa	myːsa
mysig	myːsɪɡ
mystisk	mʏstɪsk
myt	myːt
mäkla	mɛːkla
mäktig	mɛktɪɡ
män	mɛn
människa	mɛnnɪɧa
mänsklig	mɛnsklɪɡ
märklig	mærklɪɡ
mästare	mɛstarɛ
mäster	mɛstɛr
mästerskap	mɛsterskɑːp
mäta	mɛːta
må	moː
mål	moːl
måla	moːla
månad	moːnad
måndag	mɔndɑːɡ
måne	moːnɛ
mångata	moːŋɡɑːta
månsing	mɔnsɪŋ
mårka	mɔrka
mårtensgås	mɔrtɛnɡoːs
måttbestämd	mɔtbɛstɛmd
mö	møː
mög	møːɡ
mögel	møːɡɛl
möjlig	mœjlɪɡ
mölla	mœla
möp	møːp
mörk	møːrk
mörker	møːrkɛr
mörkna	møːrkna
mötesplats	møːtɛsplats
nacka	nakka
nackskinn	nakkɧɪn
nafs	nafs
nagel	nɑːɡɛl
naiv	naiːv
namn	namn
nasa	nɑːsa
nasare	nɑːsarɛ
nation	natɧuːn
nationalist	natɧʊnalɪst
nationell	natɧʊnɛl
nato	nɑːtʊ
natrium	nɑːtrɪɵm
natt	nat
natthäger	nathɛɡɛr
ned	neːd
neder	neːdɛr
nederländerna	nedɛrlɛndɛɲa
nedladdning	neːdladnɪŋ
nej	nɛj
nektarin	nɛktariːn
nellie	nɛlɪ
nelly	nɛlʏ
neodym	neːʊdyːm
neon	nɛoːn
nepalesisk	nɛpaleːsɪsk
neptunium	nɛptʉːnɪɵm
neptunus	nɛptʉːnɵs
ner	neːr
neutral	neːɵtrɑːl
neutron	neːɵtroːn
ni	niː
nicke	nɪkkɛ
niger	niːɡɛr
nigeria	nɪɡeːrɪa
nigger	nɪɡːer
nilgås	niːlɡoːs
nim	nɪm
nimma	nɪma
nio	niːʊ
nionde	niːɔndɛ
nittio	nɪtɪʊ
nitton	nɪtɔn
nja	njɑː
njalla	njala
njure	njʉːrɛ
njut	njʉːt
njuta	njʉːta
njöt	njøːt
nobba	nɔba
nobben	nɔbɛn
nobel	nʊbɛl
noll	nɔl
nominativ	nʊmɪnatiːv
nord	nuːɖ
nordbo	nuːrdbuː
nordkorea	nuːɖkʊreːa
nordsångare	nuːrdsɔŋarɛ
norge	nɔrjɛ
norr	nɔr
norrköping	nɔrɕøːpɪŋ
norrmalmstorgssyndrom	nɔrmalmstɔrjssʏndroːm
norska	nɔʂka
not	nuːt
november	nʊvɛmbɛr
nu	nʉː
nummer	nɵmɛr
nunatak	nʉːnatak
nusvenska	nʉːsvɛnska
ny	nyː
nya	nyːa
nyckel	nʏkkɛl
nying	nyːɪŋ
nypa	nyːpa
nypon	nyːpɔn
nyps	nʏps
nyttig	nʏtɪɡ
nytänkande	nyːtɛŋkande
nä	nɛː
näbbdjur	nɛbjʉːr
näckros	nɛkkruːs
nämen	nɛmɛn
nännas	nɛnas
näsa	nɛːsa
nästkusin	nɛstkɵsiːn
nätter	nɛttər
nå	noː
någon	noːɡɔn
något	noːɡɔt
några	noːɡra
nål	noːl
nålginst	noːlɡɪnst
nåt	noːt
nått	nɔt
nödrim	nøːdrɪm
nödvändig	nøːdvɛndɪɡ
nödvändighet	nøːdvɛndɪɡheːt
nörd	nøːrd
nördig	nøːrdɪɡ
nöt	nøːt
nötkråka	nøːtkroːka
nött	nœt
obelisk	obɛlɪsk
objekt	ɔbjɛkt
objektiv	ɔbjɛktiːv
obskyr	ɔbskyːr
och	ɔk
ock	ɔkk
odjur	uːjʉːr
offert	ʊfæʈ
officiell	ɔfisjɛl
offside	ɔfsajd
ogge	ɔɡɛ
ogilla	uːjɪla
ohemul	uːhemʉl
ohygglig	ʊhʏɡlɪɡ
okapabel	uːkapɑːbɛl
okej	ʊkɛj
oklar	uːklɑːr
oktober	ʊktuːbɛr
okynnesäta	uːɕʏnɛsɛːta
olaglig	uːlɑːɡlɪɡ
olle	ʊlɛ
ollon	ɔlɔn
olof	uːlɔf
olycka	uːlʏkka
olycklig	uːlʏkklɪɡ
om	ɔm
ombudsman	ɔmbʉːdsman
omfång	ɔmfɔŋ
omljud	ɔmjʉːd
omständig	ɔmstɛndɪɡ
omständlig	ɔmstɛndlɪɡ
omöjlig	uːmøjlɪɡ
onsdag	ʊnsdɑːɡ
ord	uːrd
ordbok	uːrdbuːk
orden	uːrdɛn
ordentlig	ʊɖɛntlɪɡ
order	ɔrdɛr
ordning	ɔrdnɪŋ
orientering	ɔrjɛnteːrɪŋ
orientseglare	ɔrɪjɛntseːɡlarɛ
orienttalgoxe	orijɛntaljoksɛ
orientvadarsvala	ɔrjɛntvɑːdarsvɑːla
orka	ɔrka
orkan	ʊrkɑːn
orm	ʊrm
orma	ʊrma
ormörn	ʊrmøːrn
ort	ʊʈ
osa	uːsa
oscar	ɔskar
oskar	ɔskar
oslo	ʊslʊ
oss	ɔs
osäker	uːsɛːkɛr
otagbar	uːtɑːɡbɑːr
otålig	uːtoːlɪɡ
ovan	uːvɑːn
ove	uːvɛ
overall	ʊvɛral
oxid	ɔksiːd
oändlig	ʊɛndlɪɡ
paj	paj
paket	pakeːt
palats	palats
palladium	palɑːdɪɵm
palmduva	palmdʉːva
pals	pals
paludarium	pɑːlɵdɑːrɪɵm
panda	panda
panpsykism	panpsyːkɪsm
panteon	panteʊn
pantoffel	pantɔfɛl
papegojalka	papɛɡɔjalka
papper	pappɛr
paraply	paraplyː
parentes	parɛnteːs
paris	pariːs
part	pɑːʈ
pastej	pastɛj
patent	patɛnt
paul	poːl
pava	pɑːva
pax	paks
ped	peːd
peda	peːda
pedagog	pedaɡoːɡ
pekoral	pekʊrɑːl
peng	pɛŋ
pension	panɧuːn
penultima	penɵltɪma
pep	peːp
peppar	pɛppar
period	pɛrjuːd
person	pɛʂuːn
personlig	pɛʂoːnlɪɡ
personligen	pɛʂuːnlɪɡɛn
peter	petər
picka	pɪkka
pigg	pɪɡ
pille	pɪlɛ
pin	piːn
pinje	pɪnjɛ
pipare	piːparɛ
piparsnäppa	piːparsnɛpa
piper	piːpɛr
pirog	pɪroːɡ
pizza	pɪtsa
pjäs	pjɛːs
pladdra	pladdra
planta	planta
platina	plɑːtɪna
platt	plat
plocka	plɔkka
plundring	plɵndrɪŋ
pluskvamperfekt	plɵskvampɛrfɛkt
plös	pløːs
podd	pɔd
pojk	pɔjk
pojkar	pɔjkar
pojke	pɔjkɛ
pokal	pʊkɑːl
pol	puːl
polarvarg	pʊlɑːrvarj
politik	pʊlɪtiːk
politiker	pʊliːtɪkɛr
polska	poːlska
ponke	pɔŋkɛ
pool	puːl
post	pɔst
postavi	pɔstɑːviː
potatiskorv	pʊtɑːtɪskɔrv
praktejder	praktɛjdɛr
praktmes	praktmeːs
prao	prɑːʊ
prat	prɑːt
prata	prɑːta
precis	prɛsiːs
presens	preːsɛns
present	present
pressmeddelande	prɛsmeːdeːlandɛ
preussen	prɔjsɛn
prilla	prɪlla
princip	prɪnsiːp
pris	priːs
privatjet	prɪvɑːtjɛt
problem	prʊbleːm
procent	prʊsɛnt
process	prʊsɛs
prognos	prɔɡnoːs
prosa	pruːsa
prosit	pruːsɪt
proton	prʊtoːn
prutgås	prʉːtɡoːs
prutt	prɵt
prutta	prɵtta
prärielöpare	prɛːrɪjɛløːpare
prärietrana	prɛːrɪjɛtrɑːna
prärievarg	prɛːrɪɛvarj
pröva	prøːva
prövning	prøvnɪŋ
puka	pʉːka
pulka	pɵlka
pumla	pɵmla
pungmes	pɵŋmeːs
punkt	pɵŋkt
punktlig	pɵŋktlɪɡ
purpurhäger	pɵrpɵrhɛɡɛr
pusha	pɵɧa
puss	pɵs
pussa	pɵsa
pys	pyːs
pyttipanna	pʏtɪpana
pära	pæːra
päron	pæːrɔn
på	poː
påg	poːɡ
pålägg	poːlɛɡ
påskalamm	pɔskalam
påskas	pɔskas
påskkärring	pɔskɕɛrɪŋ
påskmust	pɔskmɵst
påtår	poːtoːr
pöl	pøːl
rabatt	rabat
rabba	raba
rabbemos	rabɛmuːs
rabbis	rabɪs
radar	rɑːdar
radon	radoːn
ragge	raɡgɛ
ragnarök	raŋnarøːk
rajd	rajd
rallhäger	ralhɛɡɛr
ram	rɑːm
rand	rand
ras	rɑːs
ras	raːs
rationell	ratɧʊnɛl
realisationsvinstbeskattning	reːalɪsaɧuːnsvɪnstbɛskatnɪŋ
recept	rɛsɛpt
red	reːd
reform	refɔrm
regera	rɛjeːra
regering	rɛjeːrɪŋ
regga	rɛɡa
register	rɛjɪstɛr
registrera	rɛjɪstreːra
regn	rɛŋn
regna	reŋna
rejäl	rɛjɛːl
reklam	rɛklɑːm
reklamera	rɛklameːra
rekommendera	rɛkʊmɛndeːra
relativitet	rɛlatɪvɪteːt
relativitetsteori	rɛlatɪvɪteːtstɛʊriː
renommé	rɛnɔmeː
renommésnyltning	rɛnɔmeːsnʏltnɪŋ
rent	reːnt
rep	reːp
replokal	reːplʊkɑːl
reson	rɛsuːn
restaurang	rɛstɵraŋ
resultat	rɛsɵltɑːt
rev	reːv
revolution	rɛvʊlɵɧuːn
reykjavik	rɛjkjaviːk
ribbstol	rɪbstuːl
rik	riːk
rike	riːkɛ
riksrätt	rɪksrɛt
rikssvenska	rɪkssvɛnska
riktig	rɪktɪɡ
ringand	rɪŋand
ringduva	rɪŋdʉːva
ris	riːs
robert	roːbæʈ
rock	rɔkk
roffe	rɔfɛ
rom	ruːm
romare	rʊmarɛ
ros	ruːs
rosa	ruːsa
rosenstare	ruːsɛnstɑːrɛ
rosentärna	ruːsɛntɛrna
rosett	rʊsɛt
roskarl	ruːskɑːrl
rostand	rɔstand
rostgumpsvala	rɔstɡɵmpsvɑːla
rostmes	rɔstmeːs
rot	ruːt
rotmos	ruːtmuːs
rotting	rɔtɪŋ
rov	ruːv
rova	ruːva
ruckel	rɵkkɛl
rulle	rɵlɛ
rum	rɵm
rumänska	rɵmɛnska
russin	rɵsɪn
rwanda	rvanda
ryska	rʏska
ryssja	rʏɧa
ryttare	rʏtare
räd	rɛːd
rälig	rɛːlɪɡ
ränna	rɛna
räv	rɛːv
rävar	rɛːvar
rävtik	rɛːvtiːk
rävtikar	rɛːvtiːkar
rävtiken	rɛːvtiːkɛn
rävunge	rɛːvɵŋɛ
rå	roː
råd	roːd
rådjur	roːjʉːr
råg	roːɡ
rån	roːn
råtta	rɔta
röd	røːd
rödbena	røːdbeːna
rödfalk	røːdfalk
rödlök	røːdløːk
rödspov	røːdspuːv
rödvarg	røːdvarj
rök	røːk
rökfritt	røːkfrɪt
rökning	røːknɪŋ
rölleka	rœlɛka
rörhöna	røːrhøːna
rörlig	rœɭɪɡ
rörsångare	røːrsɔŋarɛ
rösa	røːsa
röst	rœst
rövslickare	røːvslɪkkarɛ
sa	sɑː
sabla	sɑːbla
sabotage	sabʊtɑːɧ
sade	sɑːdɛ
saft	saft
sagt	sakt
sak	sɑːk
sakna	sɑːkna
saldo	saldʊ
salt	salt
sam	sam
sambo	sambʊ
samling	samlɪŋ
sammanhänga	samanhɛŋa
samt	samt
samtal	samtɑːl
sandig	sandɪɡ
sandlöpare	sandløːpare
sandsnäppa	sandsnɛpa
sandtärna	sandtɛrna
sandvita	sandviːta
sareptasenap	sarɛptaseːnap
satan	sɑːtan
saturnus	satɵrnɵs
se	seː
sedan	seːdan
sedel	seːdɛl
seg	seːɡ
seger	seːɡɛr
segling	seːɡlɪŋ
selen	sɛleːn
semester	sɛmɛstɛr
semestrar	sɛmɛstrar
semla	semlɑ
sen	seːn
senapsgul	seːnapsɡʉːl
senapssill	seːnapssɪl
sent	seːnt
separation	separaɧuːn
september	sɛptɛmbɛr
serve	sɵrv
set	sɛt
seta	sɛːta
sett	sɛt
sevilla	sevilla
sex	sɛks
sextio	sɛkstɪʊ
sexton	sɛkstɔn
sexualitet	sɛksɵalɪteːt
sexualkunskap	sɛksɵɑːlkɵnskɑːp
sida	siːda
sikt	sɪkt
silkeshäger	sɪlkɛshɛɡɛr
sill	sɪl
sillgrissla	sɪlɡrɪsla
silltrut	sɪltrʉːt
silver	sɪlvɛr
silvertärna	sɪlvɛrtɛrna
simma	sɪma
sin	siːn
sinfonietta	sɪnfɔnɪɛta
sinnes	sɪnɛs
sitar	sɪtɑːr
sitt	sɪt
sitta	sɪta
sjal	ɧɑːl
sjok	ɧuːk
sju	ɧʉː
sjucker	ɧɵkkɛr
sjuda	ɧʉːda
sjuk	ɧʉːk
sjuka	ɧʉːka
sjukdom	ɧʉːkdʊm
sjukhus	ɧʉːkhʉːs
sjukna	ɧʉːkna
sjuksköterska	ɧʉːkɧøːtɛrska
sjukt	ɧʉːkt
sjunde	ɧɵndɛ
sjunga	ɧɵŋa
sjunka	ɧɵŋka
sjuttio	ɧɵtɪʊ
sjutton	ɧɵtɔn
själ	ɧɛːl
själv	ɧɛlv
självklar	ɧɛlvklɑːr
självklarhet	ɧɛlvklɑːrheːt
sjätte	ɧɛtɛ
sjö	ɧøː
sjökalv	ɧøːkalv
sjökvist	ɧøːkvɪst
sjöman	ɧøːman
sjön	ɧœn
sjöorre	ɧøːɔrrɛ
ska	skɑː
skabb	skab
skakis	skɑːkɪs
skakning	skɑːknɪŋ
skall	skal
skam	skam
skandium	skandɪɵm
skapa	skɑːpa
skapelse	skɑːpɛlsɛ
skatgök	skɑːtjøːk
ske	ɧeː
sked	ɧeːd
skedand	ɧeːdand
skedstork	ɧeːdstɔrk
sken	ɧeːn
skepp	ɧɛp
skepparkrans	ɧɛpparkrans
skeptisk	skɛptɪsk
skeptisk	ɧɛptɪsk
sket	ɧeːt
skev	ɧeːv
skicka	ɧɪkka
skiffer	ɧɪfɛr
skiffermes	ɧɪfɛrmeːs
skiffertrut	ɧɪfɛrtrʉːt
skildring	ɧɪldrɪŋ
skilja	ɧɪlja
skilling	ɧɪlɪŋ
skillnad	ɧɪlnad
skina	ɧiːna
skinn	ɧɪn
skit	ɧiːt
skiva	ɧiːva
skjorta	ɧʊrta
skjul	ɧʉːl
skjuta	ɧʉːta
skjutglad	ɧʉːtɡlɑːd
skjutsa	ɧɵsa
sko	skuː
skock	skɔkk
skogssnäppa	skʊɡssnɛpa
skogsstjärna	skʊksɧɛːrna
skola	skuːla
skolbespisning	skuːlbɛspiːsnɪŋ
skolka	skɔlka
skolmat	skuːlmɑːt
skolmatsal	skuːlmɑːtsɑːl
skorsten	skɔʂteːn
skorstensseglare	skɔʂteːnseːɡlarɛ
skoskav	skuːskɑːv
skotskt	skɔtskt
skottland	skɔtland
skraj	skraj
skribent	skrɪbɛnt
skridsko	skrɪskʊ
skrik	skriːk
skrikstrandpipare	skriːkstrandpiːparɛ
skrikörn	skriːkøːrn
skrin	skriːn
skriva	skriːva
skrivmaskin	skriːvmaɧiːn
skrivning	skriːvnɪŋ
skrota	skruːta
skruv	skrʉːv
skrämma	skrɛma
skräntärna	skrɛntɛrna
skula	skʉːla
skull	skɵl
skulle	skɵlə
skumvin	skʉmviːn
skur	skʉːr
skvader	skvɑːdɛr
sky	ɧyː
skydd	ɧʏd
skyddshjälm	ɧʏdsjɛlm
skyddsväg	ɕydsveːɡ
skygg	ɧʏɡ
skylt	ɧʏlt
skymma	ɧʏma
skymning	ɧʏmnɪŋ
skytt	ɧʏt
skytte	ɧʏtɛ
skytten	ɧʏtɛn
skägg	ɧɛɡ
skäggdopping	ɧɛɡdɔpɪŋ
skäggmes	ɧɛɡmeːs
skäggtärna	ɧɛɡtɛrna
skäl	ɧɛːl
skälig	ɧɛːlɪɡ
skämskudde	ɧɛmskɵdɛ
skämt	ɧɛmt
skänka	ɧɛŋka
skär	ɧæːr
skära	ɧæːra
skärfläcka	ɧɛːrflɛkka
skärp	ɧɛrp
skärpa	ɧærpa
skärsnäppa	ɧɛːrsnɛpa
skåda	skoːda
sköld	ɧœld
sköldpadda	ɧœldpada
skölja	ɧœlja
skön	ɧøːn
skörbjugg	ɧœːrbjɵɡ
sköt	ɧøːt
sköts	ɧøːts
slagsmål	slaksmoːl
slaguggla	slɑːɡɵɡla
slangens	slaŋens
sleva	sleːva
slitvarg	sliːtvarj
slog	sluːɡ
slogs	slʊgs
slussa	slɵsa
slut	slʉːt
sluten	slʉːtɛn
slutrea	slʉːtreːa
slutspurt	slʉːtspɵrt
släkt	slɛkt
slät	slɛːt
slå	sloː
slån	sloːn
slö	sløː
slöjd	slœjd
slösa	sløːsa
slöseri	sløːsɛriː
smarrig	smarɪɡ
smaska	smaska
smaskig	smaskɪɡ
smed	smeːd
smet	smeːt
smittkurva	smɪtkɵrva
smoking	smoːkɪŋ
smultron	smɵltrɔn
smultronställe	smɵltrɔnstɛlɛ
smurf	smɵrf
smutsgam	smɵtsɡɑːm
smyg	smyːɡ
små	smoː
småborgare	smoːbɔrjare
småborgerlig	smoːbɔrjɛrlɪɡ
småborgerlighet	smoːbɔrjɛrlɪɡheːt
smådopping	smoːdɔpɪŋ
småkusin	smoːkɵsiːn
smålom	smoːlʊm
småskrake	smoːkrɑːkɛ
småsnäppa	smoːsnɛpa
småtrapp	smɔtrap
småtärna	smoːtɛrna
smör	smøːr
smörgås	smœrɡoːs
smörgåsbord	smœrɡɔsbuːrd
smörgåstårta	smœrɡɔstoːrta
snabb	snab
snabbt	snapt
snacka	snakka
snapsvisa	snapsviːsa
snart	snɑːʈ
snatterand	snatɛrand
sne	sneː
snickare	snɪkkarɛ
snickeri	snɪkkɛriː
snickra	snɪkkra
snida	sniːda
sno	snuː
snor	snuːr
snudd	snɵd
snus	snuːs
snusa	snuːsa
snusare	snuːsarɛ
snusig	snuːsɪɡ
snuskhummer	snɵskhɵmɛr
snusmumrik	snuːsmɵmrɪk
snut	snʉːt
snutt	snɵt
snygging	snʏɡɪŋ
snylta	snʏlta
snyltning	snʏltnɪŋ
snäll	snɛl
snälla	snɛlla
snäppa	snɛpa
snål	snoːl
snåljåp	snoːljoːp
snålvarg	snoːlvarj
snö	snøː
snöa	snøːa
snöga	snøːɡa
snön	snœn
so	suː
social	sosiɑːl
sockenmål	sʊkkɛnmoːl
soda	suːda
sofia	sʊfiːa
sol	suːl
solk	sɔlk
solna	soːlna
solsken	suːlɧeːn
solvarg	suːlvarj
som	sɔm
sommar	sɔmmar
sommaren	sɔmarɛn
sommartid	sɔmartiːd
somras	sɔmras
son	soːn
soppa	sɔpa
sorg	sɔrj
sorl	soːrl
sortering	sʊrteːrɪŋ
sosse	sʊsɛ
sossig	sʊsɪɡ
sot	suːt
sothöna	suːthøːna
sotis	suːtɪs
sottärna	suːttɛrna
sov	soːv
sova	soːva
sovel	soːvɛl
sovjet	sʊvjeːt
sovstad	soːvstɑːd
spanska	spanska
spara	spɑːra
sparvuggla	sparvɵɡla
spasm	spasm
spegel	speːɡɛl
spel	speːl
spela	speːla
spelar	speːlar
spenat	spɛnɑːt
speta	speːta
spetsbergsgrissla	spɛtsbɛrjsɡrɪsla
spetsbergsgås	spɛtsbɛrjsɡoːs
spettekaka	spɛtɛkɑːka
spetälska	speːtælska
spik	spiːk
spis	spiːs
spisa	spiːsa
spjut	spjʉːt
sport	spʊʈ
spov	spuːv
spovsnäppa	spʊːvsnɛpa
sprida	spriːda
sprit	spriːt
spruta	sprʉːta
språk	sproːk
spurt	spɵrt
spy	spyː
spänna	spɛnna
spå	spoː
spåga	spoːɡa
spår	spoːr
spö	spøː
spöke	spøːkɛ
stab	stɑːb
stad	stɑːd
stadig	stɑːdɪɡ
stadsbo	statsbuː
stagflation	staɡflaɧuːn
stal	stɑːl
stamområde	stamɔmroːdɛ
stat	stɑːt
statlig	stɑːtlɪɡ
stav	stɑːv
stava	stɑːva
stege	steːɡɛ
stel	steːl
sten	steːn
stenfalk	steːnfalk
stensvala	steːnsvɑːla
stickelbär	stɪkkɛlbɛːr
stig	stiːɡ
stillhet	stɪlheːt
stjäl	ɧɛːl
stjäla	ɧɛːla
stjälk	ɧɛlk
stjälpa	ɧɛlpa
stjärt	ɧɛrt
stjärtand	ɧɛʈand
stockholm	stɔkkhɔlm
stockholmssyndrom	stɔkkhɔlmssʏndroːm
stod	stuːd
stoft	stɔft
stol	stuːl
stomme	stume
stor	stuːr
storlabb	stuːrlab
storlom	stuːrlʊm
storm	stɔrm
stormaktstid	stuːrmaktstiːd
stormfågel	stɔrmfoːɡɛl
storskrake	stuːrskrɑːkɛ
storspov	stuːrspuːv
stortrapp	stuːrtrap
stova	stoːva
strandskata	strandskɑːta
strass	stras
strejk	strɛjk
strontium	strɔntsɪɵm
stryka	stryːka
stråla	stroːla
stråle	stroːlə
ströbröd	strœːbrœːd
ström	strœm
strömand	strœmand
strömming	strœmɪŋ
stubb	stɵb
stubbstjärtseglare	stɵbɧɛʈseːɡlarɛ
student	stɵdɛnt
studio	stʉːdɪʊ
studsa	stɵtsa
stulit	stʉːlɪt
stut	stʉːt
styltlöpare	stʏltløːparɛ
styltsnäppa	stʏltsnɛpa
städerska	stɛːdɛʂka
ställningstagande	stɛlnɪŋstɑːɡandɛ
stämma	stɛmma
stäpp	stɛp
stäppflyghöna	stɛpflyːɡhøːna
stäpphök	stɛphøːk
stäppsångare	stɛpsɔŋarɛ
stäppvarg	stɛpvarj
stäppvipa	stɛpviːpa
stäppörn	stɛpøːrn
stå	stoː
stål	stoːl
stöd	støːd
störa	stœːra
störtregn	stɶʈrɛŋn
störtskur	stɶʈskʉːr
subjekt	sɵbjɛkt
subjektiv	sɵbjɛktiːv
substantiv	sɵbstantiːv
succé	sʉkseː
suck	sɵkk
sumpvipa	sɵmpviːpa
sund	sɵnd
sundsvall	sɵndsval
supa	sʉːpa
super	sʉːpɛr
supinum	sɵpiːnɵm
sur	sʉːr
sura	sʉːra
surströmming	sʉːrstrœmɪŋ
svag	svɑːɡ
svala	svɑːla
svan	svɑːn
svans	svans
svansrem	svansrɛm
svar	svɑːr
svara	svɑːra
svart	svart
svartand	svaʈand
svarthakedopping	svaʈhɑːkɛdɔpɪŋ
svartis	svartiːs
svartkråka	svartkroːka
svartpeppar	svaʈpɛpar
svartsenap	svaʈseːnap
svartsnäppa	svartsnɛpa
svarttärna	svarttɛrna
svarv	svarv
svavel	svɑːvɛl
sveg	sveːɡ
svek	sveːk
sven	svɛn
svensk	svɛnsk
svenska	svɛnska
svenskjävel	svɛnskjɛːvɛl
sverige	svɛrjɛ
svika	sviːka
svit	sviːt
svor	svuːr
svärd	svæːrd
svärta	svɛʈa
svåger	svoːɡər
svår	svoːr
svårt	svoːʈ
swisha	svɪɕa
syd	syːd
sydkorea	syːdkʊreːa
sydsamiska	syːdsɑːmɪska
syl	syːl
syll	sʏl
sylt	sʏlt
sylta	sʏlta
sylvass	syːlvas
symfoni	sʏmfʊniː
symfoniorkester	sʏmfʊniːɔrkɛstɛr
syntes	sʏnteːs
syra	syːra
syrak	syːrak
syre	syːrɛ
syrra	sʏra
syssling	sʏslɪŋ
syssna	sʏsna
systemet	sʏsteːmɛt
syster	sʏstɛr
sädesfrö	sɛːdɛsfrøː
sädgås	sɛːdɡoːs
säga	sɛja
säl	sɛːl
sälarna	sæːlaɳa
sälg	sɛlj
sälja	sɛlja
säljare	sɛljare
säll	sɛl
säng	sɛŋ
sängram	sɛŋrɑːm
säpo	sɛːpʊ
särbo	sɛːrbʊ
särbo	sɛːrbuː
särskild	sɛːrɧɪld
särskrivning	sɛːrskriːvnɪŋ
sätt	sɛt
sävsångare	sɛːvsɔŋarɛ
så	soː
såg	soːɡ
sågverk	soːɡvɛrk
sån	soːn
sång	sɔŋ
sångsvan	sɔŋsvɑːn
sånär	sɔnɛːr
sår	soːr
sås	soːs
söder	søːdər
södermanland	søːdɛrmanland
södertälje	sœdɛʈɛljɛ
sökbar	søkbɑːr
söm	sœm
sömn	sœmn
söndag	sœndɑːɡ
söt	søːt
sötebröd	søːtɛbrøːd
sötebrödsdagar	søːtɛbrøːdsdɑːɡar
sött	sœt
söul	søːʉːl
ta	tɑː
tabbe	tabɛ
tack	takk
tag	tɑːɡ
taggstjärtseglare	taɡɧɛʈseːɡlarɛ
taiwanmes	tajwanmeːs
tajgasädgås	tajɡaɡoːs
tajgasångare	tajɡasɔŋarɛ
tak	tɑːk
tala	tɑːla
talang	talaŋ
talko	talkɔ
tall	tal
tallbit	talbiːt
tallgråmes	talɡroːmeːs
talong	talʊŋ
tambur	tambʉːr
tand	tand
tango	taŋɡʊ
tanig	tɑːnɪɡ
tanke	taŋkɛ
tankesmedja	taŋkɛsmeːdja
tant	tant
tasse	tasɛ
tassemark	tasɛmark
tatarfalk	tatɑːrfalk
tatta	tatta
tattare	tattare
tatuera	tatɵeːra
te	teː
team	tiːm
teg	teːɡ
telefon	telefuːn
teoretiker	tɛʊreːtɪkɛr
teoretisk	tɛʊreːtɪsk
teori	tɛʊriː
tepumla	teːpɵmla
terapeutisk	terapeftɪsk
terbium	tɛrbɪɵm
tereksnäppa	tɛrɛksnɛpa
teve	teːveː
therese	tɛreːs
tid	tiːd
tiden	tiːdɛn
tidning	tiːnɪŋ
tiger	tiːɡɛr
tik	tiːk
tikar	tiːkar
tiken	tiːkɛn
till	tɪl
tillbaka	tɪlbɑːka
tillförordnad	tɪlfœːroːrdnad
tillhandahålla	tɪlhandahɔla
tills	tɪls
tillsammans	tɪlsamans
tillverkare	tɪlvɛrkarɛ
timmar	tɪmmar
tina	tiːna
tio	tiːʊ
tionde	tiːɔndɛ
tisdag	tiːsdɑːɡ
titan	tɪtɑːn
titel	tiːtɛl
tivoli	tiːvʊliː
tja	ɕa
tjabba	ɕaba
tjalla	ɕala
tjeck	ɕɛkk
tjej	ɕɛj
tjena	ɕeːna
tjenare	ɕeːnarɛ
tjenixen	ɕenɪksɛn
tji	ɕiː
tjock	ɕɔkk
tjog	ɕoːɡ
tjorre	ɕɔrɛ
tjuga	ɕʉːɡa
tjugo	ɕʉːɡʊ
tjugonde	ɕʉːɡɔndɛ
tjugotredje	ɕʉːɡʊtreːdje
tjur	ɕʉːr
tjusa	ɕʉːsa
tjuta	ɕʉːta
tjuv	ɕʉːv
tjuvsena	ɕʉvseːna
tjänare	ɕɛːnarɛ
tjänixen	ɕɛnɪksɛn
tjära	ɕɛːra
tjärn	ɕɛːrn
tjöta	ɕœːta
toa	tuːa
toalett	tuːalɛt
tobak	tuːbak
tobisgrissla	tuːbɪsɡrɪsla
toffelhjälte	tɔfɛljɛltɛ
tofflor	tɔflʊr
tofslunne	tɔfslɵnɛ
tofsvipa	tɔfsviːpa
tog	tuːɡ
tok	tuːk
tolfte	tɔlftɛ
tolv	tɔlv
tom	tuːm
tomte	tɔmte
tomten	tɔmtɛn
ton	tuːn
tonartshöjning	tuːnartshœjnɪŋ
toppskarv	tɔpskarv
tor	tuːr
torg	tɔrj
torium	tuːrɪɵm
tornedalen	toːrnɛdɑːlɛn
tornedalsfinska	toːrnɛdɑːlsfɪnska
tornseglare	tuːŋseːɡlarɛ
torsdag	tuːrsdɑːɡ
toscakaka	tɔskakɑːka
total	tʊtɑːl
tragedi	traɧɛdiː
trapp	trap
trast	trast
trastsångare	trastsɔŋarɛ
tre	treː
tredje	treːdjɛ
tremänning	treːmɛnɪŋ
tretal	treːtɑːl
trettio	trɛtɪʊ
tretton	trɛttɔn
triathlon	triːatlɔn
triljard	trɪljɑːrd
triljon	trɪljuːn
trivas	triːvas
trivsel	trɪvsel
tro	truː
troca	trɔka
troll	trɔl
trolla	trɔlla
tromsø	trʊmsœ
tron	truːn
tror	truːr
trosa	truːsa
truga	trʉːɡa
trumpet	trɵmpeːt
trä	trɛː
träd	trɛːd
trädmås	trɛdmoːs
trädpiplärka	trɛdpiːplɛrka
träl	trɛːl
träldom	trɛːldʊm
träna	trɛːna
tränga	trɛŋa
tråd	troːd
tråg	troːɡ
tsar	tsɑːr
tsunami	tsʉːnɑːmɪ
tuff	tɵf
tukan	tɵkɑːn
tundrasnäppa	tɵndraːsnɛpa
tundravarg	tɵndravarj
tung	tɵŋ
tunga	tɵŋa
tungel	tɵŋɛl
tunnbröd	tɵnbrœːd
tunnbrödsrulle	tɵnbrœːdsrɵlɛ
tunnel	tɵnɛl
tunnelbana	tɵnɛlbɑːna
turban	tɵrbɑːn
turkestantörnskata	tɵrkɛstɑːntøːrnskɑːta
tusen	tʉːsɛn
tuvsnäppa	tʉːvsnɛpa
tv	teːveː
tvedräkt	tveːdrɛkt
tveeggad	tveːɛɡad
tvegifte	tveːjɪftɛ
tvehågsen	tveːhoːɡsɛn
tvehövdad	tveːhœvdad
tvesovla	tveːsoːvla
tvestjärt	tveːɧɛrt
tvivla	tviːvla
tvärtom	tvɛːʈɔm
tvättbjörn	tvɛtbjøːɳ
tvätterska	tvɛtɛʂka
tvättmedel	tvɛtmeːdɛl
två	tvoː
tvång	tvɔŋ
tvångssvenska	tvɔŋssvenskɑ
ty	tyː
tycka	tʏkka
tyda	tyːda
tyg	tyːɡ
tygelmes	tyːɡɛlmeːs
tygeltärna	tyːɡɛltɛrna
tykobrahedag	tʏkʊbrɑːɛdɑːɡ
tyngst	tʏŋst
tysk	tʏsk
tyska	tʏska
tyskland	tʏskland
tyst	tʏst
tzatziki	tsatsiːkɪ
täcke	tɛkkɛ
täckt	tɛkkt
täkt	tɛkt
tända	tɛnda
tänkte	tɛŋktɛ
tärnmås	tɛːrnmoːs
tå	toː
tåg	toːɡ
tår	toːr
tö	tøː
töras	tøːras
törnekrona	tøːrnɛkruːna
törnskata	tøːrnskɑːta
uefa	ɵeːfa
uer	ʉːɛr
ugn	ɵŋn
ukraina	ɵkraiːna
ukulele	ɵkɵleːlɛ
ull	ɵl
ulla	ɵla
ulrika	ɵlriːka
ulv	ɵlv
umeå	ʉːmɛɔ
under	ɵndɛr
ung	ɵŋ
ungefär	ɵnjefæːr
universitet	ɵnɪvɛʂɪteːt
upp	ɵp
uppehålla	ɵppɛhɔlla
upprätt	ɵprɛt
upprätthålla	ɵprɛthɔla
uppsala	ɵpsɑːla
uppsaliensisk	ɵpsalɪɛnsɪsk
uppstyrdhet	ɵpstyːrdheːt
uppträda	ɵpptrɛːda
uppträdande	ɵptrɛːdande
uppvisning	ɵpviːsnɪŋ
uppå	ɵpoː
ur	ʉːr
uran	ɵrɑːn
uranus	ɵrɑːnɵs
urgammal	ɵrɡammal
usel	ʉːsɛl
ut	ʉːt
utan	ʉːtan
utanför	ʉːtanfœːr
utbrott	ʉːtbrɔt
utge	ʉːtjeː
utgång	ʉːtɡɔŋ
utropa	ʉːtruːpa
utslag	ʉːtslɑːɡ
uttryck	ʉːttrʏkk
utvisa	ʉːtviːsa
utvisning	ʉːtviːsnɪŋ
uv	ʉːv
uzbek	ɵsbeːk
va	vɑː
vabba	vaba
vaccin	vaksiːn
vacker	vakkɛr
vad	vɑːd
vadstena	vasteːna
vagnmakare	vaŋnmɑːkarɛ
vaj	vaj
vaja	vaja
vajsing	vajsɪŋ
vakna	vɑːkna
vakta	vakta
val	vɑːl
valack	valakk
valacka	valakka
valfläsk	vɑːlflɛsk
valk	valk
valka	valka
valkning	valknɪŋ
valsverk	valsvɛrk
vampyr	vampyːr
van	vɑːn
vandrare	vandrarɛ
vandringsord	vandrɪŋsuːrd
vann	van
vapen	vɑːpɛn
vapenhus	vɑːpɛnhʉːs
var	vɑːr
vara	vɑːra
varandra	varandra
varann	varan
varest	vɑːrɛst
varfågel	vɑːrfoːɡɛl
varför	varfœr
varg	varj
vargatid	varjatiːd
vargavinter	varjavɪntɛr
vargaväder	varjavɛːdɛr
vargbiten	varjbiːtɛn
vargflock	varjflɔk
varggrin	varjɡriːn
varggrop	varjɡruːp
varghagel	varjhɑːɡɛl
varghund	varjhɵnd
varginna	varjɪna
vargjakt	varjjakt
vargpar	varjpɑːr
vargpäls	varjpɛls
vargrevir	varjrɛviːr
vargskinn	varjɧɪn
vargspår	varjspoːr
vargstam	varjstam
vargtimma	varjtɪma
vargtimme	varjtɪme
vargtjut	varjɕʉːt
vargton	varjtuːn
vargunge	varjɵŋɛ
vargvalp	varjvalp
varit	vɑːrɪt
varken	varkɛn
varm	varm
varmt	varmt
vars	vars
varse	vɑːʂɛ
varsågod	vɑːrsɔɡuːd
vart	vart
varv	varv
vas	vɑːs
vasa	vasɑː
vass	vas
vattenrall	vatɛnral
vattensångare	vatɛnsɔŋarɛ
vattentorn	vatɛntɵːɳ
vattnen	vatnɛn
vattnet	vatnɛt
ve	veː
vecka	vɛka
vek	veːk
velociped	vɛlʊsɪpeːd
venus	veːnɵs
verk	værk
verka	vɛrka
verklighetsflykt	vɛrklɪɡheːtsflʏkt
verkstad	verksta
vessla	vɛsla
veta	veːta
vete	veːtɛ
veteran	vɛtɛrɑːn
vetja	vɛtja
vi	viː
vid	viːd
vidareutbilda	viːdarɛʉːtbɪlda
vidareutbildning	viːdarɛʉːtbɪldnɪŋ
videsångare	viːdɛsɔŋarɛ
vidskepelse	viːdɧeːpɛlsɛ
vidskeplig	viːdɧeːplɪɡ
vig	viːɡ
vigsel	vɪksel
vikt	viːkt
vilja	vɪlja
vilka	vɪlka
vilken	vɪlkɛn
vilket	vɪlkɛt
vill	vɪl
ville	vɪllɛ
vin	viːn
vind	vɪnd
vindtunnel	vɪndtɵnɛl
viner	viːnɛr
vinge	vɪŋɛ
vinter	vɪntɛr
vintertid	vɪntɛrtiːd
vintras	vɪntras
viol	vɪuːl
viola	vɪuːla
violinist	vɪʊlɪnɪst
vipa	viːpa
virre	vɪrɛ
vischan	vɪɧan
vision	vɪɧuːn
visir	vɪsiːr
vismut	vɪsmɵt
vit	viːt
vitgumpseglare	viːtɡɵmpseːɡlarɛ
vitgumpsnäppa	viːtɡɵmpsnɛpa
vitrysk	viːtrʏsk
vitryska	viːtrʏska
vitsenap	viːtseːnap
vittrut	viːttrʉːt
viv	viːv
vodka	vɔdka
volfram	vɔlfram
volvo	vɔlvʊ
vore	vuːrɛ
voss	vɔs
vred	vreːd
vredesdom	vreːdɛsdʊm
vresig	vreːsɪɡ
vuxen	vɵksɛn
vy	vyː
väcka	vɛka
väderprognos	vɛːdɛrprɔɡnoːs
väg	vɛːɡ
vägg	vɛɡ
vägra	vɛːɡra
väl	vɛːl
välbehag	vɛːlbɛhɑːɡ
välja	vɛlja
välkommen	vɛːlkɔmmɛn
vän	vɛːn
vänlig	vɛnlɪɡ
vänta	vɛnta
väntan	vɛntan
värd	vɛːɖ
värde	vɛrdɛ
värdeavi	vɛrdɛaviː
värden	væːɖɛn
värdera	vɛrdeːra
värdighet	vɛːrdɪɡheːt
värld	vɛːrd
världen	væːɖɛn
världens	væːɖɛns
värmlandskorv	vɛrmlandskɔrv
värnpliktig	vɛːrnplɪktɪɡ
värpa	værpa
värva	værva
väster	vɛstər
västerås	vɛstɛroːs
västgöte	vɛstjøːtɛ
västgötska	vɛstjøːtska
västkustskt	vɛstkɵstskt
väte	vɛːtɛ
väteperoxid	vɛːtɛpɛrɔksiːd
växellåda	vɛksɛlloːda
växjö	vɛkɧøː
växthus	vɛksthʉːs
våda	voːda
vådlig	voːdlɪɡ
våg	voːɡ
vågform	voːɡfɔrm
vålnad	voːlnad
vång	vɔŋ
vår	voːr
våradonis	voːraduːnɪs
våras	voːras
vård	voːɖ
vårdslös	voːrdsløːs
vårting	voːrtɪŋ
vårting	voːrʈɪŋ
vårtsvin	voːʈsviːn
våt	voːt
warszawa	varɧɑːva
weekend	viːkɛnd
wiccan	vɪkkan
wien	viːn
wiki	viːkɪ
xantippa	ksantɪpa
yngla	ʏŋla
yr	yːr
ystad	yːsta
yttrium	ʏtrɪɵm
yvas	yːvas
ziggis	sɪɡɪs
zink	sɪnk
zloty	slɔtʏ
zombie	sɔmbɪ
zon	suːn
zoo	suː
äckelgubbe	ɛkɛlɡɵbɛ
äcklig	ɛklɪɡ
äga	ɛːɡa
ägg	ɛɡ
äggakaka	ɛɡakɑːka
äggtoddy	ɛɡtɔdʏ
äggula	ɛɡʉːla
ägretthäger	ɛɡrɛthɛɡɛr
äldre	ɛldrɛ
äldst	ɛlst
älg	ɛlj
älgar	ɛljar
älling	ɛlɪŋ
älska	ɛlska
älta	ɛlta
älv	ɛlv
älva	ɛlva
än	ɛn
ända	ɛnda
ändelse	ɛndɛlsɛ
ändå	ɛndoː
äng	ɛŋ
ängshök	ɛŋshøːk
ängspiplärka	ɛŋspiːplɛrka
änkestöt	ɛŋkestøːt
ännu	ɛnʉː
äntligen	ɛntlɪɡɛn
äppeljuice	æpɛljuːs
äppelknyckarbyxa	ɛpɛlknʏkarbʏksa
äpple	ɛplɛ
äpplen	ɛplɛn
är	æːr
ära	æːra
ärla	ɛːrla
ärlig	æːɭɪɡ
ärt	æʈ
ät	ɛːt
äta	ɛːta
äter	ɛːtɘr
ätt	ɛt
äventyrlig	ɛːvɛntyːrlɪɡ
åboensisk	oːbʊɛnsɪsk
åda	oːda
åke	oːkɛ
ål	oːl
ålagille	oːlajɪllɛ
åland	oːland
ångmaskin	ɔŋmaɧiːn
ångström	ɔŋstrøm
ånyo	ɔnyːʊ
år	oːr
åra	oːra
åren	oːrɛn
årlig	oːɭɪɡ
årta	oːrta
ås	oːs
åsikt	oːsɪkt
åskblå	ɔskbloː
åstadkomma	oːstakɔma
åt	oːt
åtminstone	oːtmɪnstɔnɛ
åtta	ɔtta
åttio	ɔtɪʊ
åttonde	ɔtɔndɛ
ödem	ødeːm
öga	øːɡa
ökenlöpare	œkɛnløːparɛ
ökenpipare	øːkɛnpiːparɛ
öknamn	œknamn
öl	øːl
öm	œm
ömtålig	œmtoːlɪɡ
ön	øːn
öppen	œpɛn
öppenhjärtig	œpɛnjɛrtɪɡ
öppenhjärtlig	œpɛnjɛrtlɪɡ
öra	øːra
örhänge	øːrhɛŋɛ
örn	œrn
örnvinge	øːrnvɪŋɛ
örnvråk	øːrnvroːk
öronsäl	øːrɔnsɛːl
ös	øːs
öster	œstər
östersjön	østɛrɧøn
östersund	œstɛrsɵnd
östgöte	œstjøːtɛ
östgötska	œstjøːtska
över	øːvær
överflöd	øːvɛrfløːd
